1111111111111111111111111111111111
1E10000000000000000000000000000001
1010010100100000101001000000010101
1000110010101010001001000000010101
100P1000000000000000000C00000001C1
1111111111111111111111111111111111