1111111111111111111111111111111111111
11111110000000000P0001111111111111111
1111111000000000000001111111111111111
1111111000000000000001111111111111111
1111111000000000000011111111111111111
1111111000000000000011111111111111111
1111111000000000000011111111111111111
1111111000000000000011111111111111111
1111111001C00000000011111111111111111
1111111001110000000011111111111111111
1111111000000000000001111111111111111
1111111000000000000001111111111111111
1111111000000000000001111111111111111
1111111000000000000001111111111111111
111111100000000000E001111111111111111
1111111111111111111111111111111111111