1111111111111111111111111111111111
1E100000000000000000000000C0000001
101001010010C000101001000000010101
1000110010101010001001000000010101
100P100000000000000C00000000000101
1111111111111111111111111111111111